"Fecha contable",Lugar,Mes,Tipo,Nut,Valor,Numero,Concepto,"Saldo Desp.Mov",Descripcion,"Fecha Real",,
2020-07-01,"Gua-Principal ",7,CHE,,187.96,2103,"Pago De Cheques Normal Camara",2452.71,"Pago De Cheques Normal Camara","01/07/2020 4:28:10",,
2020-07-01,"Gua-Principal ",7,CHE,,375.92,2215,"Pago De Cheques Normal Camara",2076.79,"Pago De Cheques Normal Camara","01/07/2020 4:28:11",,
2020-07-01,"Gua-Principal ",7,CHE,,187.96,2023,"Pago De Cheques Normal Camara",1888.83,"Pago De Cheques Normal Camara","01/07/2020 4:28:13",,
2020-07-01,"Gua-Principal ",7,N/C,,500,1641," Int. 1434748 A 7850557 - Cuadro Abono",2388.83,"Transferencia Intermatico","01/07/2020 9:08:15",,
2020-07-01,"Gua-Principal ",7,N/D,3980675,20,816,"Elizabeth Ramirez Articulos Ca Ocp105-T C De Arte -Pr-279684",2368.83,Ocp-Pagos,"01/07/2020 9:10:20",,
2020-07-01,"Gua-Principal ",7,N/D,3980775,20,816,"Mariuxi Sarasti Compra Papel C Ocp105-T C De Arte -Pr-279684",2348.83,Ocp-Pagos,"01/07/2020 9:10:51",,
2020-07-01,"Gua-Principal ",7,N/C,4673573,68.76,517,"NO.RECAP:001393F1200701C PLA228732 MC.PAGO A ESTABL.228732000000000000     ",2417.59,Ocp-Pagos,"02/07/2020 1:04:29",,
2020-07-02,"Gua-Principal ",7,N/C,4762044,40,1945,"Concpto:01SOLICITUD DEL ORDENANTE JALON LENT GRACIELA LAURA                               000856P4",2457.59,"Transferencia Recibida Spi2 Del Bce","02/07/2020 9:26:17",,
2020-07-02,"Gua-Principal ",7,N/D,4762044,0.2,2884,"Concpto:01SOLICITUD DEL ORDENANTE JALON LENT GRACIELA LAURA                               000856P4",2457.39,"Transferencia Recibida Spi2 Del Bce","02/07/2020 9:26:17",,
2020-07-02,"Gua-Principal ",7,N/D,4762044,0.02,1613,"Concpto:01SOLICITUD DEL ORDENANTE JALON LENT GRACIELA LAURA                               000856P4",2457.37,"Transferencia Recibida Spi2 Del Bce","02/07/2020 9:26:17",,
2020-07-02,"Gua-Alban Borja",7,DEP,3275220,1000,25332295,"LOC.: 1,000.00",3457.37,Depositos,"02/07/2020 13:51:47",,
2020-07-02,"Gua-Principal ",7,N/C,5263714,35.19,517,"NO.RECAP:001394F1200702C PLA235370 MC.PAGO A ESTABL.235370000000000000     ",3492.56,Ocp-Pagos,"03/07/2020 3:06:09",,
2020-07-02,"Gua-Principal ",7,N/C,5268415,4796.49,517,"NO.RECAP:001394F1200702C PLA233602 MC.PAGO A ESTABL.233602000000000000     ",8289.05,Ocp-Pagos,"03/07/2020 3:16:55",,
2020-07-03,Gua-Unicentro,7,DEP,1387520,96,220308927,"EFE.: 96.00",8385.05,Depositos,"03/07/2020 15:54:33",,
2020-07-03,Gua-Unicentro,7,DEP,1386320,240,220308928,"EFE.: 240.00",8625.05,Depositos,"03/07/2020 15:55:39",,
2020-07-03,Gua-Unicentro,7,DEP,1385520,5180,220308926,"LOC.: 5,180.00",13805.05,Depositos,"03/07/2020 15:56:37",,
2020-07-03,Gua-Unicentro,7,CHE,1383820,422.4,2220,"Pago De Cheques Normal Ventani",13382.65,"Pago De Cheques Normal Ventanilla","03/07/2020 15:58:28",,
2020-07-03,"Gua-Principal ",7,N/C,5820875,30.79,517,"NO.RECAP:001395F1200703C PLA240469 MC.PAGO A ESTABL.240469000000000000     ",13413.44,Ocp-Pagos,"04/07/2020 0:16:29",,
2020-07-03,"Gua-Principal ",7,N/C,5825321,137.52,517,"NO.RECAP:001395F1200703C PLA238659 MC.PAGO A ESTABL.238659000000000000     ",13550.96,Ocp-Pagos,"04/07/2020 0:27:59",,
2020-07-06,"Gua-Principal ",7,CHE,,42,2218,"Pago De Cheques Normal Camara",13508.96,"Pago De Cheques Normal Camara","04/07/2020 6:21:55",,
2020-07-06,"Gua-Principal ",7,N/D,,1561.12,3056," Cfn Pce-40247032 Sec-186360  Por Cobro Comision Del 0.71 Y ",11947.84,"Notas De Debito Sin Ruta - Cuentas Y Servicios,N/D  Tran","06/07/2020 9:53:10",,
2020-07-06,"Gua-Principal ",7,N/C,,54725,3494,"Prestamo # 40247032",66672.84,"Notas De Credito - Colocaciones","06/07/2020 15:55:57",,
2020-07-06,"Gua-Principal ",7,N/C,,45,1641," Int. 1042647290 A 7850557 - Pago Mes Junio Estela Hilaca",66717.84,"Transferencia Intermatico","06/07/2020 16:40:53",,
2020-07-06,"Gua-Principal ",7,N/C,6424209,9.78,517,"NO.RECAP:001397F1200706C PLA247010 MC.PAGO A ESTABL.247010000000000000     ",66727.62,Ocp-Pagos,"07/07/2020 5:34:36",,
2020-07-06,"Gua-Principal ",7,N/C,6431410,52.52,517,"NO.RECAP:001397F1200706C PLA244237 MC.PAGO A ESTABL.244237000000000000     ",66780.14,Ocp-Pagos,"07/07/2020 5:53:04",,
2020-07-07,"Gua-Alban Borja",7,DEP,2650120,40,1,"EFE.: 40.00",66820.14,Depositos,"07/07/2020 13:42:07",,
2020-07-07,"Gua-Alban Borja",7,CHE,2649720,1315.46,2249,"Pago De Cheques Normal Ventani",65504.68,"Pago De Cheques Normal Ventanilla","07/07/2020 13:43:03",,
2020-07-07,"Gua-Alban Borja",7,CHE,2623920,1122.42,2255,"Pago De Cheques Normal Ventani",64382.26,"Pago De Cheques Normal Ventanilla","07/07/2020 14:39:05",,
2020-07-07,"Gua-Alban Borja",7,CHE,2586320,531.27,2251,"Pago De Cheques Normal Ventani",63850.99,"Pago De Cheques Normal Ventanilla","07/07/2020 15:52:00",,
2020-07-07,"Gua-Alban Borja",7,CHE,2586020,633.87,2248,"Pago De Cheques Normal Ventani",63217.12,"Pago De Cheques Normal Ventanilla","07/07/2020 15:52:14",,
2020-07-07,"Gua-Principal ",7,N/D,6786499,5.32,830,"Df 00000000002536782         . Ocp105-Datafast    -Oc-281422",63211.8,"Transacciones Ocp Débitos-Créditos","07/07/2020 17:34:55",,
2020-07-07,"Gua-Principal ",7,N/C,6846857,55,1945,"Concpto:01TRANSFERENCIA ENTRE CLIENTES MORENO SANTISTEVAN SANDRA DEL                      000856P4",63266.8,"Transferencia Recibida Spi2 Del Bce","07/07/2020 18:39:36",,
2020-07-07,"Gua-Principal ",7,N/D,6846857,0.2,2884,"Concpto:01TRANSFERENCIA ENTRE CLIENTES MORENO SANTISTEVAN SANDRA DEL                      000856P4",63266.6,"Transferencia Recibida Spi2 Del Bce","07/07/2020 18:39:36",,
2020-07-07,"Gua-Principal ",7,N/D,6846857,0.02,1613,"Concpto:01TRANSFERENCIA ENTRE CLIENTES MORENO SANTISTEVAN SANDRA DEL                      000856P4",63266.58,"Transferencia Recibida Spi2 Del Bce","07/07/2020 18:39:36",,
2020-07-08,"Gua-Principal ",7,CHE,,127,1776,"Pago De Cheques Normal Camara",63139.58,"Pago De Cheques Normal Camara","08/07/2020 3:08:27",,
2020-07-08,"Gua-Alban Borja",7,CHE,2551920,1086,2245,"Pago De Cheques Normal Ventani",62053.58,"Pago De Cheques Normal Ventanilla","08/07/2020 10:17:50",,
2020-07-08,"Gua-Alban Borja",7,CHE,2432720,684.58,2250,"Pago De Cheques Normal Ventani",61369,"Pago De Cheques Normal Ventanilla","08/07/2020 13:46:50",,
2020-07-08,"Gua-Riocentro Ceibos",7,CHE,5076820,1361.55,2241,"Pago De Cheques Normal Ventani",60007.45,"Pago De Cheques Normal Ventanilla","08/07/2020 14:46:01",,
2020-07-08,"Gua-Riocentro Ceibos",7,CHE,5076420,2216.4,2240,"Pago De Cheques Normal Ventani",57791.05,"Pago De Cheques Normal Ventanilla","08/07/2020 14:46:28",,
2020-07-08,"Gua-Riocentro Ceibos",7,DEP,5075920,87,23820,"EFE.: 87.00",57878.05,Depositos,"08/07/2020 14:47:30",,
2020-07-08,"Gua-Principal ",7,N/C,7539064,119.85,517,"NO.RECAP:001400F1200708C PLA258240 MC.PAGO A ESTABL.258240000000000000     ",57997.9,Ocp-Pagos,"09/07/2020 1:09:51",,
2020-07-08,"Gua-Principal ",7,CHE,,1954.89,2254,"Pago De Cheques  Transferido N",56043.01,"Pago De Cheques  Transferido Normal","09/07/2020 1:33:00",,
2020-07-08,"Gua-Principal ",7,CHE,,1058.23,2237,"Pago De Cheques  Transferido N",54984.78,"Pago De Cheques  Transferido Normal","09/07/2020 1:33:01",,
2020-07-08,"Gua-Principal ",7,CHE,,443.25,2239,"Pago De Cheques  Transferido N",54541.53,"Pago De Cheques  Transferido Normal","09/07/2020 1:33:01",,
2020-07-09,"Gua-Principal ",7,CHE,,1138.08,2242,"Pago De Cheques Normal Camara",53403.45,"Pago De Cheques Normal Camara","09/07/2020 3:07:24",,
2020-07-09,"Gua-Principal ",7,N/C,7571005,30,1945,"Concpto:01SOLICITUD DEL ORDENANTE ANDRADE RODRIGUEZ RODRIGO                               000856P4",53433.45,"Transferencia Recibida Spi2 Del Bce","09/07/2020 9:23:44",,
2020-07-09,"Gua-Principal ",7,N/D,7571005,0.2,2884,"Concpto:01SOLICITUD DEL ORDENANTE ANDRADE RODRIGUEZ RODRIGO                               000856P4",53433.25,"Transferencia Recibida Spi2 Del Bce","09/07/2020 9:23:44",,
2020-07-09,"Gua-Principal ",7,N/D,7571005,0.02,1613,"Concpto:01SOLICITUD DEL ORDENANTE ANDRADE RODRIGUEZ RODRIGO                               000856P4",53433.23,"Transferencia Recibida Spi2 Del Bce","09/07/2020 9:23:44",,
2020-07-09,"Gua-El Dorado",7,CHE,9271520,500,2227,"Pago De Cheques Normal Ventani",52933.23,"Pago De Cheques Normal Ventanilla","09/07/2020 12:57:10",,
2020-07-09,Gua-Aguirre,7,CHE,6251620,106.96,2104,"Pago De Cheques Normal Ventani",52826.27,"Pago De Cheques Normal Ventanilla","09/07/2020 13:17:29",,
2020-07-09,"Gua-Alban Borja",7,CHE,2242920,2755.29,2252,"Pago De Cheques Normal Ventani",50070.98,"Pago De Cheques Normal Ventanilla","09/07/2020 13:25:16",,
2020-07-09,"Gua-Nueve De Octubre",7,CHE,4035120,150,2264,"Pago De Cheques Normal Ventani",49920.98,"Pago De Cheques Normal Ventanilla","09/07/2020 14:39:27",,
2020-07-09,"Gua-Principal ",7,N/D,7784014,19.8,844,"Com.:Pago A Proveedores-01-Jun Ocp105-Pacifico    -Cb-280664",49901.18,"Transacción Débitos Ocp Con Comisión","09/07/2020 14:56:56",,
2020-07-09,"Gua-Principal ",7,N/D,7784014,2.38,1613,"Com.:Pago A Proveedores-01-Jun Ocp105-Pacifico    -Cb-280664",49898.8,"Transacción Débitos Ocp Con Comisión","09/07/2020 14:56:56",,
2020-07-09,"Gua-Principal ",7,N/D,7784016,4.95,844,"Com.:Roles De Pago-01-Jun-20 3 Ocp105-Pacifico    -Cb-280664",49893.85,"Transacción Débitos Ocp Con Comisión","09/07/2020 14:56:56",,
2020-07-09,"Gua-Principal ",7,N/D,7784016,0.59,1613,"Com.:Roles De Pago-01-Jun-20 3 Ocp105-Pacifico    -Cb-280664",49893.26,"Transacción Débitos Ocp Con Comisión","09/07/2020 14:56:56",,
2020-07-09,"Gua-Principal ",7,N/D,7784020,12.96,844,"Com.:Transferencias Interbanca Ocp105-Pacifico    -Cb-280664",49880.3,"Transacción Débitos Ocp Con Comisión","09/07/2020 14:56:57",,
2020-07-09,"Gua-Principal ",7,N/D,7784020,1.56,1613,"Com.:Transferencias Interbanca Ocp105-Pacifico    -Cb-280664",49878.74,"Transacción Débitos Ocp Con Comisión","09/07/2020 14:56:57",,
2020-07-09,Gua-Unicentro,7,CHE,9476920,258.03,2272,"Pago De Cheques Normal Ventani",49620.71,"Pago De Cheques Normal Ventanilla","09/07/2020 14:57:55",,
2020-07-09,"Gua-Riocentro Ceibos",7,CHE,4906020,1182.13,2275,"Pago De Cheques Normal Ventani",48438.58,"Pago De Cheques Normal Ventanilla","09/07/2020 15:01:58",,
2020-07-09,"Gua-Riocentro Ceibos",7,CHE,4904220,294.98,2277,"Pago De Cheques Normal Ventani",48143.6,"Pago De Cheques Normal Ventanilla","09/07/2020 15:05:49",,
2020-07-09,"Gua-Alban Borja",7,CHE,2177820,202.72,2278,"Pago De Cheques Normal Ventani",47940.88,"Pago De Cheques Normal Ventanilla","09/07/2020 15:33:13",,
2020-07-09,Gua-Urdesa,7,CHE,5055520,589.95,2274,"Pago De Cheques Normal Ventani",47350.93,"Pago De Cheques Normal Ventanilla","09/07/2020 16:00:44",,
2020-07-09,"Gua-Riocentro Sur",7,CHE,3726320,739.83,2244,"Pago De Cheques Normal Ventani",46611.1,"Pago De Cheques Normal Ventanilla","09/07/2020 16:07:50",,
2020-07-09,"Gua-Riocentro Ceibos",7,CHE,4873520,2191.5,2282,"Pago De Cheques Normal Ventani",44419.6,"Pago De Cheques Normal Ventanilla","09/07/2020 16:27:36",,
2020-07-09,"Gua-Principal ",7,N/C,8092575,73.05,517,"NO.RECAP:001401F1200709C PLA263160 MC.PAGO A ESTABL.263160000000000000     ",44492.65,Ocp-Pagos,"10/07/2020 0:21:26",,
2020-07-10,"Gua-Principal ",7,CHE,,887.58,2132,"Pago De Cheques Normal Camara",43605.07,"Pago De Cheques Normal Camara","10/07/2020 3:18:46",,
2020-07-10,"Gua-Principal ",7,CHE,,437,2283,"Pago De Cheques Normal Camara",43168.07,"Pago De Cheques Normal Camara","10/07/2020 3:18:50",,
2020-07-10,"Gua-Principal ",7,CHE,,184.24,2279,"Pago De Cheques Normal Camara",42983.83,"Pago De Cheques Normal Camara","10/07/2020 3:18:59",,
2020-07-10,"Gua-Principal ",7,CHE,,71.17,1562,"Pago De Cheques Normal Camara",42912.66,"Pago De Cheques Normal Camara","10/07/2020 3:19:01",,
2020-07-10,"Gua-Principal ",7,CHE,,79.65,1563,"Pago De Cheques Normal Camara",42833.01,"Pago De Cheques Normal Camara","10/07/2020 3:19:01",,
2020-07-10,"Gua-Principal ",7,CHE,,138.69,1983,"Pago De Cheques Normal Camara",42694.32,"Pago De Cheques Normal Camara","10/07/2020 3:19:02",,
2020-07-10,"Gua-Principal ",7,CHE,,200,2267,"Pago De Cheques Normal Camara",42494.32,"Pago De Cheques Normal Camara","10/07/2020 3:19:02",,
2020-07-10,Gua-Alborada,7,CHE,3653220,243.84,2231,"Pago De Cheques Normal Ventani",42250.48,"Pago De Cheques Normal Ventanilla","10/07/2020 8:29:13",,
2020-07-10,Gua-Alborada,7,CHE,3652920,256.72,2268,"Pago De Cheques Normal Ventani",41993.76,"Pago De Cheques Normal Ventanilla","10/07/2020 8:29:40",,
2020-07-10,Gua-Alborada,7,CHE,3652620,373.89,2129,"Pago De Cheques Normal Ventani",41619.87,"Pago De Cheques Normal Ventanilla","10/07/2020 8:30:12",,
2020-07-10,Gua-Entrerios,7,CHE,4569920,1000,2265,"Pago De Cheques Normal Ventani",40619.87,"Pago De Cheques Normal Ventanilla","10/07/2020 10:33:24",,
2020-07-10,Gua-Entrerios,7,CHE,4544820,81.28,2228,"Pago De Cheques Normal Ventani",40538.59,"Pago De Cheques Normal Ventanilla","10/07/2020 11:06:59",,
2020-07-10,"Gua-Autobanco Albanbor",7,DEP,7300520,45,225072185,"EFE.: 45.00",40583.59,Depositos,"10/07/2020 12:30:36",,
2020-07-10,Gua-Unicentro,7,CHE,9274820,196.18,2266,"Pago De Cheques Normal Ventani",40387.41,"Pago De Cheques Normal Ventanilla","10/07/2020 14:12:44",,
2020-07-10,"Gua-Mall Del Sur",7,CHE,4747220,35.56,2232,"Pago De Cheques Normal Ventani",40351.85,"Pago De Cheques Normal Ventanilla","10/07/2020 14:24:48",,
2020-07-10,"Gua-Alban Borja",7,CHE,1990920,207.55,2271,"Pago De Cheques Normal Ventani",40144.3,"Pago De Cheques Normal Ventanilla","10/07/2020 14:52:02",,
2020-07-10,"Gua-Autobanco Albanbor",7,CHE,7114920,1183.27,2246,"Pago De Cheques Normal Ventani",38961.03,"Pago De Cheques Normal Ventanilla","10/07/2020 16:25:28",,
2020-07-10,"Gua-Principal ",7,CHE,,91.75,2269,"Pago De Cheque De Transferido ",38869.28,"Pago De Cheque De Transferido Normal (Ruta)","10/07/2020 21:08:21",,
2020-07-10,"Gua-Principal ",7,N/C,8672294,79.18,517,"NO.RECAP:001402F1200710C PLA270038 MC.PAGO A ESTABL.270038000000000000     ",38948.46,Ocp-Pagos,"11/07/2020 0:29:34",,
2020-07-10,"Gua-Principal ",7,CHE,,156.8,2102,"Pago De Cheques  Transferido N",38791.66,"Pago De Cheques  Transferido Normal","11/07/2020 1:33:03",,
2020-07-10,"Gua-Principal ",7,CHE,,491.63,2276,"Pago De Cheques  Transferido N",38300.03,"Pago De Cheques  Transferido Normal","11/07/2020 1:33:07",,
2020-07-10,"Gua-Principal ",7,CHE,,830.74,2280,"Pago De Cheques  Transferido N",37469.29,"Pago De Cheques  Transferido Normal","11/07/2020 1:33:18",,
2020-07-13,"Gua-Principal ",7,CHE,,713,2257,"Pago De Cheques Normal Camara",36756.29,"Pago De Cheques Normal Camara","11/07/2020 4:02:33",,
2020-07-13,"Gua-Riocentro Ceibos",7,CHE,4675120,251.92,2281,"Pago De Cheques Normal Ventani",36504.37,"Pago De Cheques Normal Ventanilla","11/07/2020 10:37:35",,
2020-07-13,"Gua-Alban Borja",7,CHE,1847720,254,2045,"Pago De Cheques Normal Ventani",36250.37,"Pago De Cheques Normal Ventanilla","11/07/2020 13:58:54",,
2020-07-13,"Gua-Principal ",7,N/C,8787204,45,1945,"Concpto:01SOLICITUD DEL ORDENANTE ALARCON NEYRA JOSE RAFAEL                               000856P4",36295.37,"Transferencia Recibida Spi2 Del Bce","13/07/2020 10:10:41",,
2020-07-13,"Gua-Principal ",7,N/D,8787204,0.2,2884,"Concpto:01SOLICITUD DEL ORDENANTE ALARCON NEYRA JOSE RAFAEL                               000856P4",36295.17,"Transferencia Recibida Spi2 Del Bce","13/07/2020 10:10:41",,
2020-07-13,"Gua-Principal ",7,N/D,8787204,0.02,1613,"Concpto:01SOLICITUD DEL ORDENANTE ALARCON NEYRA JOSE RAFAEL                               000856P4",36295.15,"Transferencia Recibida Spi2 Del Bce","13/07/2020 10:10:41",,
2020-07-13,"Gua-Alban Borja",7,CHE,1822320,280.31,2270,"Pago De Cheques Normal Ventani",36014.84,"Pago De Cheques Normal Ventanilla","13/07/2020 10:29:02",,
2020-07-13,"Gua-Alban Borja",7,CHE,1748420,401.32,2236,"Pago De Cheques Normal Ventani",35613.52,"Pago De Cheques Normal Ventanilla","13/07/2020 12:42:07",,
2020-07-13,"Gua-Principal ",7,N/C,9300838,24.44,517,"NO.RECAP:001404F1200713C PLA276582 MC.PAGO A ESTABL.276582000000000000     ",35637.96,Ocp-Pagos,"14/07/2020 0:19:25",,
2020-07-13,"Gua-Principal ",7,N/C,9310715,12.41,517,"NO.RECAP:001405F1200713C PLA273898 MC.PAGO A ESTABL.273898000000000000     ",35650.37,Ocp-Pagos,"14/07/2020 0:37:03",,
2020-07-13,"Gua-Principal ",7,CHE,,1832,2222,"Pago De Cheques  Transferido N",33818.37,"Pago De Cheques  Transferido Normal","14/07/2020 1:05:49",,
2020-07-13,"Gua-Principal ",7,CHE,,158.84,2101,"Pago De Cheques  Transferido N",33659.53,"Pago De Cheques  Transferido Normal","14/07/2020 1:05:57",,
2020-07-14,"Gua-Principal ",7,CHE,,500,2221,"Pago De Cheques Normal Camara",33159.53,"Pago De Cheques Normal Camara","14/07/2020 4:54:27",,
2020-07-14,"Gua-Mall Del Sol",7,CHE,1628120,948.05,2238,"Pago De Cheques Normal Ventani",32211.48,"Pago De Cheques Normal Ventanilla","14/07/2020 14:49:45",,
2020-07-14,"Gua-Alban Borja",7,DEP,1448320,46,25080040,"EFE.: 46.00",32257.48,Depositos,"14/07/2020 16:07:41",,
2020-07-14,"Gua-Alban Borja",7,DEP,1446820,10,25082431,"EFE.: 10.00",32267.48,Depositos,"14/07/2020 16:09:58",,
2020-07-14,"Gua-Alban Borja",7,DEP,1445820,40,25082430,"EFE.: 40.00",32307.48,Depositos,"14/07/2020 16:11:04",,
2020-07-14,"Gua-Alban Borja",7,CHE,1443820,158,2263,"Pago De Cheques Normal Ventani",32149.48,"Pago De Cheques Normal Ventanilla","14/07/2020 16:13:46",,
2020-07-15,"Gua-Paseo Shopping Dur",7,CHE,2977520,1699.47,2247,"Pago De Cheques Normal Ventani",30450.01,"Pago De Cheques Normal Ventanilla","15/07/2020 9:12:33",,
2020-07-15,"Gua-Principal ",7,N/C,9901337,35,1945,"Concpto:01PAGO MES DE JULIO MA VICTORIA ALFREDO GEOVANNY                                  000856P4",30485.01,"Transferencia Recibida Spi2 Del Bce","15/07/2020 9:32:56",,
2020-07-15,"Gua-Principal ",7,N/D,9901337,0.2,2884,"Concpto:01PAGO MES DE JULIO MA VICTORIA ALFREDO GEOVANNY                                  000856P4",30484.81,"Transferencia Recibida Spi2 Del Bce","15/07/2020 9:32:56",,
2020-07-15,"Gua-Principal ",7,N/D,9901337,0.02,1613,"Concpto:01PAGO MES DE JULIO MA VICTORIA ALFREDO GEOVANNY                                  000856P4",30484.79,"Transferencia Recibida Spi2 Del Bce","15/07/2020 9:32:56",,
2020-07-15,"Gua-Principal ",7,N/C,,24,1641," Int. 2168200 A 7850557 - Pago De Media Caja De Vino",30508.79,"Transferencia Intermatico","15/07/2020 19:42:36",,
2020-07-15,"Gua-Principal ",7,N/C,561597,39.59,517,"NO.RECAP:001407F1200715C PLA289802 MC.PAGO A ESTABL.289802000000000000     ",30548.38,Ocp-Pagos,"16/07/2020 0:32:35",,
2020-07-15,"Gua-Principal ",7,CHE,,1000,2258,"Pago De Cheques  Transferido N",29548.38,"Pago De Cheques  Transferido Normal","16/07/2020 0:53:24",,
2020-07-15,"Gua-Principal ",7,CHE,,60.96,2229,"Pago De Cheques  Transferido N",29487.42,"Pago De Cheques  Transferido Normal","16/07/2020 0:53:26",,
2020-07-16,"Gua-Principal ",7,CHE,,500,2224,"Pago De Cheques Normal Camara",28987.42,"Pago De Cheques Normal Camara","16/07/2020 3:19:45",,
2020-07-16,"Gua-Alban Borja",7,DEP,1180720,200,168058752,"EFE.: 200.00",29187.42,Depositos,"16/07/2020 10:45:18",,
2020-07-16,Gua-Urdesa,7,CHE,3938520,500,2302,"Pago De Cheques Normal Ventani",28687.42,"Pago De Cheques Normal Ventanilla","16/07/2020 11:56:02",,
2020-07-16,"Gua-Principal ",7,N/D,757615,2099.33,1992,"Sri                          . Ocp105-Pacifico    -C1-283421",26588.09,"Transacción Débitos Ocp Con Comisión","16/07/2020 12:47:34",,
2020-07-16,"Gua-Principal ",7,N/D,757615,0.2,3060,"Sri                          . Ocp105-Pacifico    -C1-283421",26587.89,"Transacción Débitos Ocp Con Comisión","16/07/2020 12:47:34",,
2020-07-16,"Gua-Principal ",7,N/D,757615,0.02,1613,"Sri                          . Ocp105-Pacifico    -C1-283421",26587.87,"Transacción Débitos Ocp Con Comisión","16/07/2020 12:47:34",,
2020-07-16,"Gua-Principal ",7,N/D,757704,862.96,1992,"Sri                          . Ocp105-Pacifico    -C1-283421",25724.91,"Transacción Débitos Ocp Con Comisión","16/07/2020 12:47:36",,
2020-07-16,"Gua-Principal ",7,N/D,757704,0.2,3060,"Sri                          . Ocp105-Pacifico    -C1-283421",25724.71,"Transacción Débitos Ocp Con Comisión","16/07/2020 12:47:36",,
2020-07-16,"Gua-Principal ",7,N/D,757704,0.02,1613,"Sri                          . Ocp105-Pacifico    -C1-283421",25724.69,"Transacción Débitos Ocp Con Comisión","16/07/2020 12:47:36",,
2020-07-16,Gua-Unicentro,7,CHE,8221220,128,2284,"Pago De Cheques Normal Ventani",25596.69,"Pago De Cheques Normal Ventanilla","16/07/2020 14:28:01",,
2020-07-16,"Gua-Principal ",7,N/C,1150604,19.1,517,"NO.RECAP:001408F1200716C PLA293044 MC.PAGO A ESTABL.293044000000000000     ",25615.79,Ocp-Pagos,"17/07/2020 0:48:53",,
2020-07-17,"Gua-Principal ",7,CHE,,418.86,2230,"Pago De Cheques Normal Camara",25196.93,"Pago De Cheques Normal Camara","17/07/2020 4:26:56",,
2020-07-17,"Gua-Autobanco Albanbor",7,CHE,5047020,31.55,2296,"Pago De Cheques Normal Ventani",25165.38,"Pago De Cheques Normal Ventanilla","17/07/2020 12:21:07",,
2020-07-17,"Gua-Autobanco Albanbor",7,CHE,5046220,136.71,2301,"Pago De Cheques Normal Ventani",25028.67,"Pago De Cheques Normal Ventanilla","17/07/2020 12:21:38",,
2020-07-17,"Gua-Alban Borja",7,CHE,9939420,183.25,2287,"Pago De Cheques Normal Ventani",24845.42,"Pago De Cheques Normal Ventanilla","17/07/2020 12:24:33",,
2020-07-17,"Gua-Alban Borja",7,CHE,9932020,189.85,2289,"Pago De Cheques Normal Ventani",24655.57,"Pago De Cheques Normal Ventanilla","17/07/2020 12:42:27",,
2020-07-17,"Gua-Autobanco Albanbor",7,CHE,4967220,94.64,2299,"Pago De Cheques Normal Ventani",24560.93,"Pago De Cheques Normal Ventanilla","17/07/2020 13:47:57",,
2020-07-17,"Gua-Principal ",7,CHE,,203.2,2223,"Pago De Cheques  Transferido N",24357.73,"Pago De Cheques  Transferido Normal","18/07/2020 0:44:07",,
2020-07-20,"Gua-Principal ",7,CHE,,212.95,2288,"Pago De Cheques Normal Camara",24144.78,"Pago De Cheques Normal Camara","18/07/2020 4:25:48",,
2020-07-20,"Gua-Principal ",7,CHE,,136.71,2298,"Pago De Cheques Normal Camara",24008.07,"Pago De Cheques Normal Camara","18/07/2020 4:25:55",,
2020-07-20,"Gua-Principal ",7,CHE,,195.02,2291,"Pago De Cheques Normal Camara",23813.05,"Pago De Cheques Normal Camara","18/07/2020 4:25:55",,
2020-07-20,"Gua-Principal ",7,CHE,,406.4,2234,"Pago De Cheques Normal Camara",23406.65,"Pago De Cheques Normal Camara","18/07/2020 4:26:10",,
2020-07-20,"Gua-Riocentro Norte",7,CHE,4100020,52.58,2295,"Pago De Cheques Normal Ventani",23354.07,"Pago De Cheques Normal Ventanilla","20/07/2020 11:10:36",,
2020-07-20,"Gua-Riocentro Norte",7,CHE,4099520,94.64,2300,"Pago De Cheques Normal Ventani",23259.43,"Pago De Cheques Normal Ventanilla","20/07/2020 11:11:12",,
2020-07-20,"Gua-Principal ",7,N/C,,406.4,387,00002234-303-2020-07-20,23665.83,"Devolución Por Forma Y Firma Cámara (Pagado);","20/07/2020 15:34:24",,
2020-07-20,"Gua-Principal ",7,N/C,2594306,22,517,"NO.RECAP:001412F1200720C PLA306606 MC.PAGO A ESTABL.306606000000000000     ",23687.83,Ocp-Pagos,"21/07/2020 0:15:32",,
2020-07-20,"Gua-Principal ",7,N/C,2604701,30.08,517,"NO.RECAP:001410F1200720C PLA303866 MC.PAGO A ESTABL.303866000000000000     ",23717.91,Ocp-Pagos,"21/07/2020 0:35:01",,
2020-07-21,"Gua-Principal ",7,CHE,,120,2285,"Pago De Cheques Normal Camara",23597.91,"Pago De Cheques Normal Camara","21/07/2020 4:30:10",,
2020-07-21,Gua-Policentro,7,CHE,5466020,141,2293,"Pago De Cheques Normal Ventani",23456.91,"Pago De Cheques Normal Ventanilla","21/07/2020 15:00:15",,
2020-07-21,"Gua-Principal ",7,N/C,3071498,100,1945,"Concpto:01TRANSFERENCIA ENTRE CLIENTES MACIAS AMORES CARLOS VICTOR                        000856P4",23556.91,"Transferencia Recibida Spi2 Del Bce","21/07/2020 18:29:45",,
2020-07-21,"Gua-Principal ",7,N/D,3071498,0.2,2884,"Concpto:01TRANSFERENCIA ENTRE CLIENTES MACIAS AMORES CARLOS VICTOR                        000856P4",23556.71,"Transferencia Recibida Spi2 Del Bce","21/07/2020 18:29:45",,
2020-07-21,"Gua-Principal ",7,N/D,3071498,0.02,1613,"Concpto:01TRANSFERENCIA ENTRE CLIENTES MACIAS AMORES CARLOS VICTOR                        000856P4",23556.69,"Transferencia Recibida Spi2 Del Bce","21/07/2020 18:29:45",,
2020-07-22,"Gua-Principal ",7,CHE,,406.4,2234,"Pago De Cheques Normal Camara",23150.29,"Pago De Cheques Normal Camara","22/07/2020 3:57:13",,
2020-07-22,"Gua-Principal ",7,CHE,,1292.96,2273,"Pago De Cheques Normal Camara",21857.33,"Pago De Cheques Normal Camara","22/07/2020 3:57:28",,
2020-07-22,"Gua-Principal ",7,CHE,,53.76,2109,"Pago De Cheques Normal Camara",21803.57,"Pago De Cheques Normal Camara","22/07/2020 3:57:29",,
2020-07-22,"Gua-Principal ",7,N/C,3197715,40,1945,"Concpto:01TEATRO GARDENIA LEONOR                                                          000856P4",21843.57,"Transferencia Recibida Spi2 Del Bce","22/07/2020 9:18:46",,
2020-07-22,"Gua-Principal ",7,N/D,3197715,0.2,2884,"Concpto:01TEATRO GARDENIA LEONOR                                                          000856P4",21843.37,"Transferencia Recibida Spi2 Del Bce","22/07/2020 9:18:46",,
2020-07-22,"Gua-Principal ",7,N/D,3197715,0.02,1613,"Concpto:01TEATRO GARDENIA LEONOR                                                          000856P4",21843.35,"Transferencia Recibida Spi2 Del Bce","22/07/2020 9:18:46",,
2020-07-22,"Gua-Principal ",7,N/C,3200873,50,1945,"Concpto:01CUOTA EXTRAORDINARIA CECILIA MARIA                                              000856P4",21893.35,"Transferencia Recibida Spi2 Del Bce","22/07/2020 9:19:44",,
2020-07-22,"Gua-Principal ",7,N/D,3200873,0.2,2884,"Concpto:01CUOTA EXTRAORDINARIA CECILIA MARIA                                              000856P4",21893.15,"Transferencia Recibida Spi2 Del Bce","22/07/2020 9:19:44",,
2020-07-22,"Gua-Principal ",7,N/D,3200873,0.02,1613,"Concpto:01CUOTA EXTRAORDINARIA CECILIA MARIA                                              000856P4",21893.13,"Transferencia Recibida Spi2 Del Bce","22/07/2020 9:19:44",,
2020-07-22,"Gua-Principal ",7,N/D,3287086,87.92,1992,"Confianza                    . Ocp105-Pacifico    -C1-284685",21805.21,"Transacción Débitos Ocp Con Comisión","22/07/2020 12:34:42",,
2020-07-22,"Gua-Principal ",7,N/D,3287086,0.2,3060,"Confianza                    . Ocp105-Pacifico    -C1-284685",21805.01,"Transacción Débitos Ocp Con Comisión","22/07/2020 12:34:43",,
2020-07-22,"Gua-Principal ",7,N/D,3287086,0.02,1613,"Confianza                    . Ocp105-Pacifico    -C1-284685",21804.99,"Transacción Débitos Ocp Con Comisión","22/07/2020 12:34:43",,
2020-07-22,"Gua-Principal ",7,N/C,3674328,106.47,517,"NO.RECAP:001414F1200722C PLA318237 MC.PAGO A ESTABL.318237000000000000     ",21911.46,Ocp-Pagos,"23/07/2020 0:13:36",,
2020-07-23,"Gua-Principal ",7,N/C,3719958,45,1945,"Concpto:01PENA  PIGUAVE ALEX FERNANDO-PAGOS INTERBANCARIOS (SPI) PENA  PIGUAVE ALEX FERNAN000856P4",21956.46,"Transferencia Recibida Spi2 Del Bce","23/07/2020 9:23:29",,
2020-07-23,"Gua-Principal ",7,N/D,3719958,0.2,2884,"Concpto:01PENA  PIGUAVE ALEX FERNANDO-PAGOS INTERBANCARIOS (SPI) PENA  PIGUAVE ALEX FERNAN000856P4",21956.26,"Transferencia Recibida Spi2 Del Bce","23/07/2020 9:23:30",,
2020-07-23,"Gua-Principal ",7,N/D,3719958,0.02,1613,"Concpto:01PENA  PIGUAVE ALEX FERNANDO-PAGOS INTERBANCARIOS (SPI) PENA  PIGUAVE ALEX FERNAN000856P4",21956.24,"Transferencia Recibida Spi2 Del Bce","23/07/2020 9:23:30",,
2020-07-23,"Gua-Principal ",7,DEP,,300,"01000201 9082","EFE.: 300.00",22256.24,Depositos,"23/07/2020 15:15:39",,
2020-07-23,"Gua-Principal ",7,DEP,,50,"01000201 9092","EFE.: 50.00",22306.24,Depositos,"23/07/2020 15:18:14",,
2020-07-23,"Gua-Principal ",7,DEP,,24,"01000201 9102","EFE.: 24.00",22330.24,Depositos,"23/07/2020 15:20:00",,
2020-07-23,"Gua-Principal ",7,DEP,,1512.56,"01000201 9112","LOC.: 1,512.56",23842.8,Depositos,"23/07/2020 15:23:10",,
2020-07-23,Gua-Entrerios,7,DEP,9743620,100,22150393,"EFE.: 100.00",23942.8,Depositos,"23/07/2020 16:04:23",,
2020-07-24,"Gua-Principal ",7,CHE,,136.71,2297,"Pago De Cheques Normal Camara",23806.09,"Pago De Cheques Normal Camara","24/07/2020 3:14:51",,
2020-07-24,"Gua-Principal ",7,CHE,,136.71,2292,"Pago De Cheques Normal Camara",23669.38,"Pago De Cheques Normal Camara","24/07/2020 3:14:59",,
2020-07-24,"Gua-Principal ",7,N/C,4184724,45,1945,"Concpto:01SOLICITUD DEL ORDENANTE VILLALA PEREZ GINGER KATIUSK                            000856P4",23714.38,"Transferencia Recibida Spi2 Del Bce","24/07/2020 9:35:59",,
2020-07-24,"Gua-Principal ",7,N/D,4184724,0.2,2884,"Concpto:01SOLICITUD DEL ORDENANTE VILLALA PEREZ GINGER KATIUSK                            000856P4",23714.18,"Transferencia Recibida Spi2 Del Bce","24/07/2020 9:35:59",,
2020-07-24,"Gua-Principal ",7,N/D,4184724,0.02,1613,"Concpto:01SOLICITUD DEL ORDENANTE VILLALA PEREZ GINGER KATIUSK                            000856P4",23714.16,"Transferencia Recibida Spi2 Del Bce","24/07/2020 9:35:59",,
2020-07-24,"Pla-Principal Paseo Sh",7,CHE,7761220,72.2,2286,"Pago De Cheques Normal Ventani",23641.96,"Pago De Cheques Normal Ventanilla","24/07/2020 10:47:07",,
2020-07-27,Qui-Principal,7,DEP,7883570,45,TBBA-02-0007-FC_USER,"EFE.: 45.00",23686.96,Depositos,"27/07/2020 9:34:04",,
2020-07-27,Gua-Aguirre,7,DEP,2729020,4793.6,521561,"LOC.: 4,793.60",28480.56,Depositos,"27/07/2020 13:50:14",,
2020-07-27,Gua-Aguirre,7,DEP,2728720,2016,61651,"LOC.: 2,016.00",30496.56,Depositos,"27/07/2020 13:50:44",,
2020-07-27,Gua-Aguirre,7,DEP,2728520,36,15651,"LOC.: 36.00",30532.56,Depositos,"27/07/2020 13:51:26",,
2020-07-27,Gua-Aguirre,7,CHE,2680920,12129.93,2305,"Pago De Cheques Normal Ventani",18402.63,"Pago De Cheques Normal Ventanilla","27/07/2020 14:59:25",,
2020-07-27,Gua-Aguirre,7,CHE,2669520,9992.77,2306,"Pago De Cheques Normal Ventani",8409.86,"Pago De Cheques Normal Ventanilla","27/07/2020 15:15:29",,
2020-07-27,"Gua-Principal ",7,N/C,5069428,63.5,517,"NO.RECAP:001419F1200727C PLA334270 MC.PAGO A ESTABL.334270000000000000     ",8473.36,Ocp-Pagos,"28/07/2020 1:01:28",,
2020-07-28,"Gua-Principal ",7,CHE,,1311,2235,"Pago De Cheques Normal Camara",7162.36,"Pago De Cheques Normal Camara","28/07/2020 5:38:01",,
2020-07-28,"Gua-Riocentro Norte",7,CHE,2791820,609.6,2303,"Pago De Cheques Normal Ventani",6552.76,"Pago De Cheques Normal Ventanilla","28/07/2020 11:18:16",,
2020-07-28,"Gua-Principal ",7,N/D,,4793.6,65,00000019-1-2020-07-28,1759.16,"Devolucion Cheques Locales","28/07/2020 18:18:43",,
2020-07-28,"Gua-Principal ",7,N/D,,2.49,2040,00000019-1-2020-07-28,1756.67,"Devolucion Cheques Locales","28/07/2020 18:18:43",,
2020-07-28,"Gua-Principal ",7,N/D,,0.3,1613,00000019-1-2020-07-28,1756.37,"Devolucion Cheques Locales","28/07/2020 18:18:43",,
2020-07-29,"Gua-Principal ",7,N/C,6096408,87.98,517,"NO.RECAP:001421F1200729C PLA350425 MC.PAGO A ESTABL.350425000000000000     ",1844.35,Ocp-Pagos,"30/07/2020 0:09:50",,
2020-07-29,"Gua-Principal ",7,N/C,6100112,38.68,517,"NO.RECAP:001421F1200729C PLA348631 MC.PAGO A ESTABL.348631000000000000     ",1883.03,Ocp-Pagos,"30/07/2020 0:20:26",,
2020-07-29,"Gua-Principal ",7,CHE,,313.99,2304,"Pago De Cheques  Transferido N",1569.04,"Pago De Cheques  Transferido Normal","30/07/2020 1:10:59",,
2020-07-30,"Gua-Principal ",7,CHE,,3196.02,2243,"Pago De Cheques  Transferido N",-1626.98,"Pago De Cheques  Transferido Normal","30/07/2020 8:03:13",,
2020-07-30,"Gua-Principal ",7,N/C,6602180,30.08,517,"NO.RECAP:001422F1200730C PLA353796 MC.PAGO A ESTABL.353796000000000000     ",-1596.9,Ocp-Pagos,"31/07/2020 0:39:17",,
2020-07-30,"Gua-Principal ",7,N/C,6603192,42.97,517,"NO.RECAP:001201F1200730C PLA354303 MC.PAGO A ESTABL.354303000000000000     ",-1553.93,Ocp-Pagos,"31/07/2020 0:42:09",,
2020-07-31,"Gua-Principal ",7,CHE,,660,2226,"Pago De Cheques Normal Camara",-2213.93,"Pago De Cheques Normal Camara","31/07/2020 8:25:58",,
2020-07-31,"Gua-Principal ",7,N/C,,100,1641," Int. 1052758796 A 7850557 - Tranf De Cta Socias A Cta Cte P",-2113.93,"Transferencia Intermatico","31/07/2020 9:15:46",,
2020-07-31,"Gua-Principal ",7,N/D,,0.02,2660,"Contrib. Financ. Solca",-2113.95,"Cobro Comision Por Soc,Soi,Sct Y Imp","31/07/2020 9:15:46",,
2020-07-31,"Gua-Principal ",7,N/D,,0.48,53,"Cobro De Intereses Por Sobregi",-2114.43,"Liquidación - Comisión Ufb / Sobregiros","31/07/2020 9:15:46",,
2020-07-31,"Gua-Principal ",7,CHE,,330,1971,"Pago De Cheques Normal Camara",-2444.43,"Pago De Cheques Normal Camara","31/07/2020 9:24:47",,
2020-07-31,Gua-Urdesa,7,DEP,1632620,30,321631,"EFE.: 30.00",-2414.43,Depositos,"31/07/2020 12:03:03",,
2020-07-31,"Gua-Principal ",7,N/C,,330,387,00001971-303-2020-07-31,-2084.43,"Devolución Por Forma Y Firma Cámara (Pagado);","31/07/2020 15:30:56",,
2020-07-31,"Gua-Principal ",7,N/C,,660,387,00002226-303-2020-07-31,-1424.43,"Devolución Por Forma Y Firma Cámara (Pagado);","31/07/2020 15:30:56",,
2020-07-31,"Gua-Principal ",7,N/C,7230104,1000,1945,"Concpto:01TICKETSHOW S A-PAGO A TERCEROS TICKETSHOW S A                                   000856P4",-424.43,"Transferencia Recibida Spi2 Del Bce","31/07/2020 20:56:17",,
2020-07-31,"Gua-Principal ",7,N/D,7230104,0.2,2884,"Concpto:01TICKETSHOW S A-PAGO A TERCEROS TICKETSHOW S A                                   000856P4",-424.63,"Transferencia Recibida Spi2 Del Bce","31/07/2020 20:56:17",,
2020-07-31,"Gua-Principal ",7,N/D,7230104,0.02,1613,"Concpto:01TICKETSHOW S A-PAGO A TERCEROS TICKETSHOW S A                                   000856P4",-424.65,"Transferencia Recibida Spi2 Del Bce","31/07/2020 20:56:17",,
2020-07-31,"Gua-Principal ",7,N/C,7277380,39.59,517,"NO.RECAP:001423F1200731C PLA360882 MC.PAGO A ESTABL.360882000000000000     ",-385.06,Ocp-Pagos,"01/08/2020 0:15:15",,
2020-07-31,"Gua-Principal ",7,N/C,7281176,19.1,517,"NO.RECAP:001423F1200731C PLA359038 MC.PAGO A ESTABL.359038000000000000     ",-365.96,Ocp-Pagos,"01/08/2020 0:27:08",,
2020-08-03,"Gua-Principal ",8,CHE,,330,1971,"Pago De Cheques Normal Camara",-695.96,"Pago De Cheques Normal Camara","03/08/2020 8:43:20",,
2020-08-03,"Gua-Principal ",8,CHE,,660,2226,"Pago De Cheques Normal Camara",-1355.96,"Pago De Cheques Normal Camara","03/08/2020 8:43:20",,
2020-08-03,"Gua-Principal ",8,N/C,7516541,547.68,1945,"Concpto:01TRANSFERENCIA ENTRE CLIENTES MARTINEZ FLORENCIA CHRISTIAN D                     000856P4",-808.28,"Transferencia Recibida Spi2 Del Bce","03/08/2020 10:30:47",,
2020-08-03,"Gua-Principal ",8,N/D,7516541,0.2,2884,"Concpto:01TRANSFERENCIA ENTRE CLIENTES MARTINEZ FLORENCIA CHRISTIAN D                     000856P4",-808.48,"Transferencia Recibida Spi2 Del Bce","03/08/2020 10:30:47",,
2020-08-03,"Gua-Principal ",8,N/D,7516541,0.02,1613,"Concpto:01TRANSFERENCIA ENTRE CLIENTES MARTINEZ FLORENCIA CHRISTIAN D                     000856P4",-808.5,"Transferencia Recibida Spi2 Del Bce","03/08/2020 10:30:47",,
2020-08-03,"Gua-Principal ",8,N/D,7516541,0.03,2660,"Contrib. Financ. Solca",-808.53,"Cobro Comision Por Soc,Soi,Sct Y Imp","03/08/2020 10:30:47",,
2020-08-03,"Gua-Principal ",8,N/D,7516541,0.33,53,"Cobro De Intereses Por Sobregi",-808.86,"Liquidación - Comisión Ufb / Sobregiros","03/08/2020 10:30:47",,
2020-08-03,"Gua-Principal ",8,N/C,,45,1641," Int. 1042647290 A 7850557 - Pago Julio Estela Hilaca",-763.86,"Transferencia Intermatico","03/08/2020 14:04:12",,
2020-08-03,"Gua-Principal ",8,N/C,8045323,40,1945,"Concpto:01SOLICITUD DEL ORDENANTE ANDRADE RODRIGUEZ RODRIGO                               000856P4",-723.86,"Transferencia Recibida Spi2 Del Bce","03/08/2020 18:59:51",,
2020-08-03,"Gua-Principal ",8,N/D,8045323,0.2,2884,"Concpto:01SOLICITUD DEL ORDENANTE ANDRADE RODRIGUEZ RODRIGO                               000856P4",-724.06,"Transferencia Recibida Spi2 Del Bce","03/08/2020 18:59:51",,
2020-08-03,"Gua-Principal ",8,N/D,8045323,0.02,1613,"Concpto:01SOLICITUD DEL ORDENANTE ANDRADE RODRIGUEZ RODRIGO                               000856P4",-724.08,"Transferencia Recibida Spi2 Del Bce","03/08/2020 18:59:51",,
2020-08-03,"Gua-Principal ",8,N/C,,60,2168," 515202 01003009 2020-07-31 7850557 162 60",-664.08,"Notas De Credito - Cuentas Y Servicios,N/C Tran","03/08/2020 19:25:55",,
2020-08-03,"Gua-Principal ",8,N/C,8142783,141.75,517,"NO.RECAP:001202F1200803C PLA368144 MC.PAGO A ESTABL.368144000000000000     ",-522.33,Ocp-Pagos,"04/08/2020 0:56:58",,
2020-08-03,"Gua-Principal ",8,N/C,8150759,9.55,517,"NO.RECAP:001424F1200803C PLA364799 MC.PAGO A ESTABL.364799000000000000     ",-512.78,Ocp-Pagos,"04/08/2020 1:10:52",,
2020-08-03,"Gua-Principal ",8,N/C,8153671,47.75,517,"NO.RECAP:001202F1200803C PLA365576 MC.PAGO A ESTABL.365576000000000000     ",-465.03,Ocp-Pagos,"04/08/2020 1:15:29",,
2020-08-04,"Gua-Principal ",8,N/C,8251032,439.16,1945,"Concpto:01TICKETSHOW S A-PAGO A TERCEROS TICKETSHOW S A                                   000856P4",-25.87,"Transferencia Recibida Spi2 Del Bce","04/08/2020 9:31:38",,
2020-08-04,"Gua-Principal ",8,N/D,8251032,0.2,2884,"Concpto:01TICKETSHOW S A-PAGO A TERCEROS TICKETSHOW S A                                   000856P4",-26.07,"Transferencia Recibida Spi2 Del Bce","04/08/2020 9:31:38",,
2020-08-04,"Gua-Principal ",8,N/D,8251032,0.02,1613,"Concpto:01TICKETSHOW S A-PAGO A TERCEROS TICKETSHOW S A                                   000856P4",-26.09,"Transferencia Recibida Spi2 Del Bce","04/08/2020 9:31:38",,
2020-08-04,"Gua-Principal ",8,N/D,8251032,0.01,2660,"Contrib. Financ. Solca",-26.1,"Cobro Comision Por Soc,Soi,Sct Y Imp","04/08/2020 9:31:38",,
2020-08-04,"Gua-Principal ",8,N/D,8251032,0.14,53,"Cobro De Intereses Por Sobregi",-26.24,"Liquidación - Comisión Ufb / Sobregiros","04/08/2020 9:31:38",,
2020-08-04,"Gua-Principal ",8,N/C,8747801,30.79,517,"NO.RECAP:001427F1200804C PLA376087 MC.PAGO A ESTABL.376087000000000000     ",4.55,Ocp-Pagos,"05/08/2020 0:20:33",,
2020-08-04,"Gua-Principal ",8,N/D,8747801,0.32,1613,"Chq: 2243 ",4.23,"Cobro De Cons Occh","05/08/2020 0:20:33",,
2020-08-04,"Gua-Principal ",8,N/D,8747801,2.68,2017,"Chq: 2243 ",1.55,"Cobro De Cons Occh","05/08/2020 0:20:33",,
2020-08-04,"Gua-Principal ",8,N/C,8752523,167.6,517,"NO.RECAP:001427F1200804C PLA374273 MC.PAGO A ESTABL.374273000000000000     ",169.15,Ocp-Pagos,"05/08/2020 0:31:43",,
2020-08-04,"Gua-Principal ",8,N/D,8752523,0.32,1613,"Chq: 2226 1971 ",168.83,"Cobro De Cons Occh","05/08/2020 0:31:43",,
2020-08-04,"Gua-Principal ",8,N/D,8752523,2.68,2017,"Chq: 2226 1971 ",166.15,"Cobro De Cons Occh","05/08/2020 0:31:43",,
2020-08-04,"Gua-Principal ",8,N/D,8752523,0.32,1613,"Chq: 1971 2226 ",165.83,"Cobro De Cons Occh","05/08/2020 0:31:43",,
2020-08-04,"Gua-Principal ",8,N/D,8752523,2.68,2017,"Chq: 1971 2226 ",163.15,"Cobro De Cons Occh","05/08/2020 0:31:43",,
2020-08-05,"Gua-Principal ",8,N/C,8825982,40,1945,"Concpto:01SOLICITUD DEL ORDENANTE JALON LENT GRACIELA LAURA                               000856P4",203.15,"Transferencia Recibida Spi2 Del Bce","05/08/2020 9:27:18",,
2020-08-05,"Gua-Principal ",8,N/D,8825982,0.2,2884,"Concpto:01SOLICITUD DEL ORDENANTE JALON LENT GRACIELA LAURA                               000856P4",202.95,"Transferencia Recibida Spi2 Del Bce","05/08/2020 9:27:18",,
2020-08-05,"Gua-Principal ",8,N/D,8825982,0.02,1613,"Concpto:01SOLICITUD DEL ORDENANTE JALON LENT GRACIELA LAURA                               000856P4",202.93,"Transferencia Recibida Spi2 Del Bce","05/08/2020 9:27:18",,
2020-08-05,"Gua-Principal ",8,CHE,,166.73,2262,"Pago De Cheques Normal Camara",36.2,"Pago De Cheques Normal Camara","05/08/2020 9:33:35",,
2020-08-05,"Gua-Principal ",8,N/C,8940182,10,1945,"Concpto:01SOLICITUD DEL ORDENANTE JALON LENT GRACIELA LAURA                               000856P4",46.2,"Transferencia Recibida Spi2 Del Bce","05/08/2020 13:27:55",,
2020-08-05,"Gua-Principal ",8,N/D,8940182,0.2,2884,"Concpto:01SOLICITUD DEL ORDENANTE JALON LENT GRACIELA LAURA                               000856P4",46,"Transferencia Recibida Spi2 Del Bce","05/08/2020 13:27:55",,
2020-08-05,"Gua-Principal ",8,N/D,8940182,0.02,1613,"Concpto:01SOLICITUD DEL ORDENANTE JALON LENT GRACIELA LAURA                               000856P4",45.98,"Transferencia Recibida Spi2 Del Bce","05/08/2020 13:27:55",,
2020-08-05,"Gua-Principal ",8,N/C,9244887,2279.2,1945,"Concpto:50PAGO MUN. GUAYAQUIL - CTA. GENERAL                                              000856P4",2325.18,"Transferencia Recibida Spi2 Del Bce","05/08/2020 18:49:56",,
2020-08-05,"Gua-Principal ",8,N/D,9244887,0.2,2884,"Concpto:50PAGO MUN. GUAYAQUIL - CTA. GENERAL                                              000856P4",2324.98,"Transferencia Recibida Spi2 Del Bce","05/08/2020 18:49:56",,
2020-08-05,"Gua-Principal ",8,N/D,9244887,0.02,1613,"Concpto:50PAGO MUN. GUAYAQUIL - CTA. GENERAL                                              000856P4",2324.96,"Transferencia Recibida Spi2 Del Bce","05/08/2020 18:49:56",,
2020-08-06,"Gua-Principal ",8,N/D,,2.68,2017,"Chq: 2262 ",2322.28,"Cargo Por Uso De Occh-Rescate","06/08/2020 2:03:06",,
2020-08-06,"Gua-Principal ",8,N/D,,0.32,1613,"Chq: 2262 ",2321.96,"Cargo Por Uso De Occh-Rescate","06/08/2020 2:03:06",,
2020-08-06,"Gua-Principal ",8,N/C,9341035,25,1945,"Concpto:01CHIRIBOGA  GUEVARA JOHN JACOB-PAGOS INTERBANCARIOS (SPI) CHIRIBOGA  GUEVARA JOHN000856P4",2346.96,"Transferencia Recibida Spi2 Del Bce","06/08/2020 9:25:47",,
2020-08-06,"Gua-Principal ",8,N/D,9341035,0.2,2884,"Concpto:01CHIRIBOGA  GUEVARA JOHN JACOB-PAGOS INTERBANCARIOS (SPI) CHIRIBOGA  GUEVARA JOHN000856P4",2346.76,"Transferencia Recibida Spi2 Del Bce","06/08/2020 9:25:47",,
2020-08-06,"Gua-Principal ",8,N/D,9341035,0.02,1613,"Concpto:01CHIRIBOGA  GUEVARA JOHN JACOB-PAGOS INTERBANCARIOS (SPI) CHIRIBOGA  GUEVARA JOHN000856P4",2346.74,"Transferencia Recibida Spi2 Del Bce","06/08/2020 9:25:47",,
2020-08-06,"Gua-Principal ",8,N/D,9648616,0.9,844,"Com.:Pago A Proveedores-01-Jul Ocp105-Pacifico    -Cb-288067",2345.84,"Transacción Débitos Ocp Con Comisión","06/08/2020 17:34:00",,
2020-08-06,"Gua-Principal ",8,N/D,9648616,0.11,1613,"Com.:Pago A Proveedores-01-Jul Ocp105-Pacifico    -Cb-288067",2345.73,"Transacción Débitos Ocp Con Comisión","06/08/2020 17:34:00",,
2020-08-06,"Gua-Principal ",8,N/D,9848499,5.32,830,"Df 00000000002588217         . Ocp105-Datafast    -Oc-288266",2340.41,"Transacciones Ocp Débitos-Créditos","06/08/2020 22:25:02",,
2020-08-06,"Gua-Principal ",8,N/C,9860914,40.38,517,"NO.RECAP:001429F1200806C PLA386569 MC.PAGO A ESTABL.386569000000000000     ",2380.79,Ocp-Pagos,"07/08/2020 0:24:38",,
2020-08-06,"Gua-Principal ",8,N/C,9865998,33.42,517,"NO.RECAP:001428F1200806C PLA384770 MC.PAGO A ESTABL.384770000000000000     ",2414.21,Ocp-Pagos,"07/08/2020 0:37:09",,
2020-08-07,Gua-Aguirre,8,DEP,8809320,100,25633021,"EFE.: 100.00",2514.21,Depositos,"07/08/2020 15:25:09",,
2020-08-07,"Gua-Principal ",8,N/C,,2000,1641," Int. 7780745 A 7850557 - Alquiler Teatro Plv2020",4514.21,"Transferencia Intermatico","07/08/2020 18:14:09",,
2020-08-07,"Gua-Principal ",8,N/C,434479,22,517,"NO.RECAP:001430F1200807C PLA391933 MC.PAGO A ESTABL.391933000000000000     ",4536.21,Ocp-Pagos,"08/08/2020 1:02:18",,
2020-08-07,"Gua-Principal ",8,N/C,439464,73.05,517,"NO.RECAP:001430F1200807C PLA390014 MC.PAGO A ESTABL.390014000000000000     ",4609.26,Ocp-Pagos,"08/08/2020 1:14:07",,
2020-08-11,"Gua-Principal ",8,N/C,590121,40,1945,"Concpto:01AGOSTO GARDENIA LEONOR                                                          000856P4",4649.26,"Transferencia Recibida Spi2 Del Bce","11/08/2020 9:45:38",,
2020-08-11,"Gua-Principal ",8,N/D,590121,0.2,2884,"Concpto:01AGOSTO GARDENIA LEONOR                                                          000856P4",4649.06,"Transferencia Recibida Spi2 Del Bce","11/08/2020 9:45:38",,
2020-08-11,"Gua-Principal ",8,N/D,590121,0.02,1613,"Concpto:01AGOSTO GARDENIA LEONOR                                                          000856P4",4649.04,"Transferencia Recibida Spi2 Del Bce","11/08/2020 9:45:38",,
2020-08-11,"Gua-Principal ",8,N/C,625023,45,1945,"Concpto:01SOLICITUD DEL ORDENANTE ALARCON NEYRA JOSE RAFAEL                               000856P4",4694.04,"Transferencia Recibida Spi2 Del Bce","11/08/2020 9:55:16",,
2020-08-11,"Gua-Principal ",8,N/D,625023,0.2,2884,"Concpto:01SOLICITUD DEL ORDENANTE ALARCON NEYRA JOSE RAFAEL                               000856P4",4693.84,"Transferencia Recibida Spi2 Del Bce","11/08/2020 9:55:16",,
2020-08-11,"Gua-Principal ",8,N/D,625023,0.02,1613,"Concpto:01SOLICITUD DEL ORDENANTE ALARCON NEYRA JOSE RAFAEL                               000856P4",4693.82,"Transferencia Recibida Spi2 Del Bce","11/08/2020 9:55:16",,
2020-08-11,"Gua-Alban Borja",8,CHE,6337020,450.61,2308,"Pago De Cheques Normal Ventani",4243.21,"Pago De Cheques Normal Ventanilla","11/08/2020 10:18:10",,
2020-08-11,"Gua-Principal ",8,N/C,,620,1641," Int. 1434748 A 7850557 - Cuadro Saldo",4863.21,"Transferencia Intermatico","11/08/2020 16:28:36",,
2020-08-11,"Gua-Principal ",8,N/C,1193641,70.39,517,"NO.RECAP:001434F1200811C PLA399242 MC.PAGO A ESTABL.399242000000000000     ",4933.6,Ocp-Pagos,"12/08/2020 0:41:50",,
2020-08-11,"Gua-Principal ",8,N/C,1204550,77.35,517,"NO.RECAP:001434F1200811C PLA396070 MC.PAGO A ESTABL.396070000000000000     ",5010.95,Ocp-Pagos,"12/08/2020 1:00:53",,
2020-08-12,"Gua-Alban Borja",8,DEP,5975820,50,1,"LOC.: 50.00",5060.95,Depositos,"12/08/2020 15:01:01",,
2020-08-12,"Gua-Alban Borja",8,DEP,5975420,370,1,"EFE.: 370.00",5430.95,Depositos,"12/08/2020 15:01:37",,
2020-08-12,"Gua-Alban Borja",8,DEP,5975120,190,1,"EFE.: 190.00",5620.95,Depositos,"12/08/2020 15:02:25",,
2020-08-12,"Gua-Alban Borja",8,DEP,5974920,48,1,"LOC.: 48.00",5668.95,Depositos,"12/08/2020 15:03:04",,
2020-08-12,"Gua-Principal ",8,N/C,1790109,21.49,517,"NO.RECAP:001435F1200812C PLA407705 MC.PAGO A ESTABL.407705000000000000     ",5690.44,Ocp-Pagos,"13/08/2020 0:37:43",,
2020-08-13,"Gua-Principal ",8,CHE,,274,2307,"Pago De Cheques Normal Camara",5416.44,"Pago De Cheques Normal Camara","13/08/2020 6:17:52",,
2020-08-13,"Gua-Principal ",8,CHE,,156.44,2261,"Pago De Cheques Normal Camara",5260,"Pago De Cheques Normal Camara","13/08/2020 6:17:59",,
2020-08-13,"Gua-Principal ",8,N/C,1843965,55,1945,"Concpto:01SOLICITUD DEL ORDENANTE CEDENO BRIONES MARIA CAROLIN                            000856P4",5315,"Transferencia Recibida Spi2 Del Bce","13/08/2020 9:27:41",,
2020-08-13,"Gua-Principal ",8,N/D,1843965,0.2,2884,"Concpto:01SOLICITUD DEL ORDENANTE CEDENO BRIONES MARIA CAROLIN                            000856P4",5314.8,"Transferencia Recibida Spi2 Del Bce","13/08/2020 9:27:41",,
2020-08-13,"Gua-Principal ",8,N/D,1843965,0.02,1613,"Concpto:01SOLICITUD DEL ORDENANTE CEDENO BRIONES MARIA CAROLIN                            000856P4",5314.78,"Transferencia Recibida Spi2 Del Bce","13/08/2020 9:27:41",,
2020-08-13,"Gua-Alban Borja",8,CHE,5862920,1415,2311,"Pago De Cheques Normal Ventani",3899.78,"Pago De Cheques Normal Ventanilla","13/08/2020 12:02:58",,
2020-08-13,"Gua-Alban Borja",8,CHE,5860520,2959.02,2315,"Pago De Cheques Normal Ventani",940.76,"Pago De Cheques Normal Ventanilla","13/08/2020 12:06:13",,
2020-08-13,"Gua-Principal ",8,N/C,2308040,35,1945,"Concpto:01PAGO MA VICTORIA BAQUERIZO ART ALFREDO GEOVANNY                                 000856P4",975.76,"Transferencia Recibida Spi2 Del Bce","13/08/2020 18:33:18",,
2020-08-13,"Gua-Principal ",8,N/D,2308040,0.2,2884,"Concpto:01PAGO MA VICTORIA BAQUERIZO ART ALFREDO GEOVANNY                                 000856P4",975.56,"Transferencia Recibida Spi2 Del Bce","13/08/2020 18:33:18",,
2020-08-13,"Gua-Principal ",8,N/D,2308040,0.02,1613,"Concpto:01PAGO MA VICTORIA BAQUERIZO ART ALFREDO GEOVANNY                                 000856P4",975.54,"Transferencia Recibida Spi2 Del Bce","13/08/2020 18:33:18",,
2020-08-14,"Gua-Principal ",8,N/C,,55,1641," Int. 1011826886 A 7850557 - Pago Curso",1030.54,"Transferencia Intermatico","14/08/2020 20:55:06",,
2020-08-14,"Gua-Principal ",8,N/C,3182755,8288,817,"Factura 001-001-0034291 Op No. Ocp105-Pacifico Ec -Pr-289889",9318.54,Ocp-Pagos,"14/08/2020 22:02:36",,
2020-08-14,"Gua-Principal ",8,N/C,3182757,8288,817,"Factura 001-001-0034368 Op No. Ocp105-Pacifico Ec -Pr-289890",17606.54,Ocp-Pagos,"14/08/2020 22:02:36",,
2020-08-14,"Gua-Principal ",8,N/C,3199964,42.97,517,"NO.RECAP:001437F1200814C PLA418239 MC.PAGO A ESTABL.418239000000000000     ",17649.51,Ocp-Pagos,"15/08/2020 0:17:47",,
2020-08-17,"Gua-Riocentro Ceibos",8,CHE,9032220,2191.5,2333,"Pago De Cheques Normal Ventani",15458.01,"Pago De Cheques Normal Ventanilla","15/08/2020 11:06:05",,
2020-08-17,"Gua-Riocentro Sur",8,DEP,8600820,25,25201382,"EFE.: 25.00",15483.01,Depositos,"15/08/2020 12:38:58",,
2020-08-17,"Gua-Riocentro Sur",8,DEP,8600620,70,25201381,"EFE.: 70.00",15553.01,Depositos,"15/08/2020 12:39:23",,
2020-08-17,"Gua-Alban Borja",8,CHE,5419220,281.02,2317,"Pago De Cheques Normal Ventani",15271.99,"Pago De Cheques Normal Ventanilla","15/08/2020 12:40:02",,
2020-08-17,"Gua-Riocentro Ceibos",8,CHE,8971720,251.92,2331,"Pago De Cheques Normal Ventani",15020.07,"Pago De Cheques Normal Ventanilla","15/08/2020 13:07:42",,
2020-08-17,"Gua-Riocentro Ceibos",8,CHE,8970020,294.98,2329,"Pago De Cheques Normal Ventani",14725.09,"Pago De Cheques Normal Ventanilla","15/08/2020 13:11:26",,
2020-08-17,"Gua-Alban Borja",8,CHE,5402720,204.68,2330,"Pago De Cheques Normal Ventani",14520.41,"Pago De Cheques Normal Ventanilla","15/08/2020 13:15:53",,
2020-08-17,"Gua-Alban Borja",8,CHE,5391620,529.95,2325,"Pago De Cheques Normal Ventani",13990.46,"Pago De Cheques Normal Ventanilla","15/08/2020 13:44:01",,
2020-08-17,"Gua-Via A La Costa",8,DEP,5145820,40,225724145,"EFE.: 40.00",14030.46,Depositos,"17/08/2020 9:19:33",,
2020-08-17,"Gua-Principal ",8,N/C,3364848,55,1945,"Concpto:01TALLER DE TEATRO MUSICAL MARTHA MARIA                                           000856P4",14085.46,"Transferencia Recibida Spi2 Del Bce","17/08/2020 9:33:18",,
2020-08-17,"Gua-Principal ",8,N/D,3364848,0.2,2884,"Concpto:01TALLER DE TEATRO MUSICAL MARTHA MARIA                                           000856P4",14085.26,"Transferencia Recibida Spi2 Del Bce","17/08/2020 9:33:18",,
2020-08-17,"Gua-Principal ",8,N/D,3364848,0.02,1613,"Concpto:01TALLER DE TEATRO MUSICAL MARTHA MARIA                                           000856P4",14085.24,"Transferencia Recibida Spi2 Del Bce","17/08/2020 9:33:18",,
2020-08-17,"Gua-Principal ",8,N/C,,55,1641," Int. 1010081240 A 7850557 - Inscripcion Nancy Vasconez",14140.24,"Transferencia Intermatico","17/08/2020 10:14:43",,
2020-08-17,"Gua-Alban Borja",8,CHE,5299420,214.13,2313,"Pago De Cheques Normal Ventani",13926.11,"Pago De Cheques Normal Ventanilla","17/08/2020 12:44:53",,
2020-08-17,"Gua-Alban Borja",8,CHE,5298720,89.58,2314,"Pago De Cheques Normal Ventani",13836.53,"Pago De Cheques Normal Ventanilla","17/08/2020 12:45:29",,
2020-08-17,"Gua-Alban Borja",8,CHE,5298320,193.44,2316,"Pago De Cheques Normal Ventani",13643.09,"Pago De Cheques Normal Ventanilla","17/08/2020 12:45:59",,
2020-08-17,"Gua-Alban Borja",8,CHE,5297920,258.26,2312,"Pago De Cheques Normal Ventani",13384.83,"Pago De Cheques Normal Ventanilla","17/08/2020 12:46:34",,
2020-08-17,"Gua-Principal ",8,N/C,3577346,200,1945,"Concpto:01PRIMERA CUOTA ACUERDO DE PAGO ROSA VICTORIA                                     000856P4",13584.83,"Transferencia Recibida Spi2 Del Bce","17/08/2020 13:24:42",,
2020-08-17,"Gua-Principal ",8,N/D,3577346,0.2,2884,"Concpto:01PRIMERA CUOTA ACUERDO DE PAGO ROSA VICTORIA                                     000856P4",13584.63,"Transferencia Recibida Spi2 Del Bce","17/08/2020 13:24:42",,
2020-08-17,"Gua-Principal ",8,N/D,3577346,0.02,1613,"Concpto:01PRIMERA CUOTA ACUERDO DE PAGO ROSA VICTORIA                                     000856P4",13584.61,"Transferencia Recibida Spi2 Del Bce","17/08/2020 13:24:42",,
2020-08-17,"Gua-Alban Borja",8,CHE,5250320,82.44,2319,"Pago De Cheques Normal Ventani",13502.17,"Pago De Cheques Normal Ventanilla","17/08/2020 14:31:51",,
2020-08-17,"Gua-Alban Borja",8,CHE,5221620,1182.13,2327,"Pago De Cheques Normal Ventani",12320.04,"Pago De Cheques Normal Ventanilla","17/08/2020 15:28:36",,
2020-08-17,"Gua-Alban Borja",8,DEP,5221420,110,199721773,"EFE.: 110.00",12430.04,Depositos,"17/08/2020 15:29:11",,
2020-08-17,"Gua-Alban Borja",8,CHE,5219320,258.07,2320,"Pago De Cheques Normal Ventani",12171.97,"Pago De Cheques Normal Ventanilla","17/08/2020 15:35:14",,
2020-08-17,"Gua-Principal ",8,N/C,4000893,52.52,517,"NO.RECAP:001439F1200817C PLA424295 MC.PAGO A ESTABL.424295000000000000     ",12224.49,Ocp-Pagos,"18/08/2020 1:06:42",,
2020-08-17,"Gua-Principal ",8,CHE,,491.63,2328,"Pago De Cheques  Transferido N",11732.86,"Pago De Cheques  Transferido Normal","18/08/2020 1:57:43",,
2020-08-18,"Gua-Alban Borja",8,CHE,5050120,208.31,2318,"Pago De Cheques Normal Ventani",11524.55,"Pago De Cheques Normal Ventanilla","18/08/2020 14:01:54",,
2020-08-18,"Gua-Principal ",8,N/C,4725985,39.59,517,"NO.RECAP:001429F1200818C PLA436049 MC.PAGO A ESTABL.436049000000000000     ",11564.14,Ocp-Pagos,"19/08/2020 2:48:44",,
2020-08-18,"Gua-Principal ",8,N/C,4729839,38.68,517,"NO.RECAP:001441F1200818C PLA434152 MC.PAGO A ESTABL.434152000000000000     ",11602.82,Ocp-Pagos,"19/08/2020 2:56:54",,
2020-08-19,"Gua-Principal ",8,N/C,,2748.8,1641," Int. 7780745 A 7850557 - Saldo Fact 34370 Y Fact 34373",14351.62,"Transferencia Intermatico","19/08/2020 12:40:19",,
2020-08-19,"Gua-Principal ",8,N/C,4908399,55,1945,"Concpto:01SAN MARTIN  TAPIA MARY BETHZABE-PAGOS INTERBANCARIOS (SPI) SAN MARTIN  TAPIA MAR000856P4",14406.62,"Transferencia Recibida Spi2 Del Bce","19/08/2020 13:15:51",,
2020-08-19,"Gua-Principal ",8,N/D,4908399,0.2,2884,"Concpto:01SAN MARTIN  TAPIA MARY BETHZABE-PAGOS INTERBANCARIOS (SPI) SAN MARTIN  TAPIA MAR000856P4",14406.42,"Transferencia Recibida Spi2 Del Bce","19/08/2020 13:15:51",,
2020-08-19,"Gua-Principal ",8,N/D,4908399,0.02,1613,"Concpto:01SAN MARTIN  TAPIA MARY BETHZABE-PAGOS INTERBANCARIOS (SPI) SAN MARTIN  TAPIA MAR000856P4",14406.4,"Transferencia Recibida Spi2 Del Bce","19/08/2020 13:15:51",,
2020-08-19,"Gua-Principal ",8,DEP,2351220,500,1997217980,"LOC.: 500.00",14906.4,Depositos,"19/08/2020 14:53:57",,
2020-08-19,"Gua-Principal ",8,N/C,5225507,10,1945,"Concpto:01AGOSTO GARDENIA LEONOR                                                          000856P4",14916.4,"Transferencia Recibida Spi2 Del Bce","19/08/2020 18:48:47",,
2020-08-19,"Gua-Principal ",8,N/D,5225507,0.2,2884,"Concpto:01AGOSTO GARDENIA LEONOR                                                          000856P4",14916.2,"Transferencia Recibida Spi2 Del Bce","19/08/2020 18:48:47",,
2020-08-19,"Gua-Principal ",8,N/D,5225507,0.02,1613,"Concpto:01AGOSTO GARDENIA LEONOR                                                          000856P4",14916.18,"Transferencia Recibida Spi2 Del Bce","19/08/2020 18:48:47",,
2020-08-19,"Gua-Principal ",8,N/C,5316023,6.16,517,"NO.RECAP:001442F1200819C PLA441337 MC.PAGO A ESTABL.441337000000000000     ",14922.34,Ocp-Pagos,"20/08/2020 0:49:06",,
2020-08-19,"Gua-Principal ",8,N/C,5319794,30.08,517,"NO.RECAP:001442F1200819C PLA439438 MC.PAGO A ESTABL.439438000000000000     ",14952.42,Ocp-Pagos,"20/08/2020 1:00:20",,
2020-08-20,Gua-Urdesa,8,DEP,7415620,40,19972782,"EFE.: 40.00",14992.42,Depositos,"20/08/2020 11:48:44",,
2020-08-20,Gua-Urdesa,8,CHE,7412620,438.5,2334,"Pago De Cheques Normal Ventani",14553.92,"Pago De Cheques Normal Ventanilla","20/08/2020 11:51:39",,
2020-08-20,"Gua-Riocentro Norte",8,CHE,7855420,609.6,2360,"Pago De Cheques Normal Ventani",13944.32,"Pago De Cheques Normal Ventanilla","20/08/2020 11:57:51",,
2020-08-20,"Gua-Autobanco Albanbor",8,CHE,3532020,136.71,2353,"Pago De Cheques Normal Ventani",13807.61,"Pago De Cheques Normal Ventanilla","20/08/2020 12:56:03",,
2020-08-20,"Gua-Autobanco Albanbor",8,CHE,3531720,94.64,2347,"Pago De Cheques Normal Ventani",13712.97,"Pago De Cheques Normal Ventanilla","20/08/2020 12:56:27",,
2020-08-20,"Gua-Principal ",8,N/D,5479987,87.92,1992,"Confianza                    . Ocp105-Pacifico    -C1-291215",13625.05,"Transacción Débitos Ocp Con Comisión","20/08/2020 13:09:55",,
2020-08-20,"Gua-Principal ",8,N/D,5479987,0.2,3060,"Confianza                    . Ocp105-Pacifico    -C1-291215",13624.85,"Transacción Débitos Ocp Con Comisión","20/08/2020 13:09:55",,
2020-08-20,"Gua-Principal ",8,N/D,5479987,0.02,1613,"Confianza                    . Ocp105-Pacifico    -C1-291215",13624.83,"Transacción Débitos Ocp Con Comisión","20/08/2020 13:09:55",,
2020-08-20,"Gua-Alban Borja",8,CHE,4664320,147.22,2352,"Pago De Cheques Normal Ventani",13477.61,"Pago De Cheques Normal Ventanilla","20/08/2020 13:30:31",,
2020-08-20,Gua-Urdesa,8,CHE,7345720,431.16,2348,"Pago De Cheques Normal Ventani",13046.45,"Pago De Cheques Normal Ventanilla","20/08/2020 13:44:24",,
2020-08-20,"Gua-Principal ",8,N/C,5824344,39.59,517,"NO.RECAP:001443F1200820C PLA446834 MC.PAGO A ESTABL.446834000000000000     ",13086.04,Ocp-Pagos,"21/08/2020 0:09:13",,
2020-08-20,"Gua-Principal ",8,N/C,5828336,9.54,517,"NO.RECAP:001443F1200820C PLA444870 MC.PAGO A ESTABL.444870000000000000     ",13095.58,Ocp-Pagos,"21/08/2020 0:18:48",,
2020-08-20,"Gua-Principal ",8,CHE,,804.61,2344,"Pago De Cheques  Transferido N",12290.97,"Pago De Cheques  Transferido Normal","21/08/2020 1:13:54",,
2020-08-21,"Gua-Principal ",8,CHE,,199.61,2359,"Pago De Cheques Normal Camara",12091.36,"Pago De Cheques Normal Camara","21/08/2020 3:24:45",,
2020-08-21,"Gua-Principal ",8,CHE,,147.22,2343,"Pago De Cheques Normal Camara",11944.14,"Pago De Cheques Normal Camara","21/08/2020 3:24:58",,
2020-08-21,"Gua-Principal ",8,CHE,,147.22,2356,"Pago De Cheques Normal Camara",11796.92,"Pago De Cheques Normal Camara","21/08/2020 3:24:59",,
2020-08-21,"Gua-Alban Borja",8,CHE,4547120,197.73,2309,"Pago De Cheques Normal Ventani",11599.19,"Pago De Cheques Normal Ventanilla","21/08/2020 10:50:33",,
2020-08-21,"Gua-Principal ",8,CHE,1560420,42.06,2355,"Pago De Cheques Normal Ventani",11557.13,"Pago De Cheques Normal Ventanilla","21/08/2020 12:53:26",,
2020-08-21,"Gua-Mall Del Sur",8,CHE,6173920,203.2,2350,"Pago De Cheques Normal Ventani",11353.93,"Pago De Cheques Normal Ventanilla","21/08/2020 13:32:35",,
2020-08-21,"Gua-Autobanco Albanbor",8,DEP,3052320,45,225072184,"EFE.: 45.00",11398.93,Depositos,"21/08/2020 13:34:39",,
2020-08-21,Gua-Aguirre,8,CHE,5568620,183.25,2339,"Pago De Cheques Normal Ventani",11215.68,"Pago De Cheques Normal Ventanilla","21/08/2020 16:01:15",,
2020-08-21,Gua-Policentro,8,DEP,,75,"01005002 9821","EFE.: 75.00",11290.68,Depositos,"21/08/2020 16:19:40",,
2020-08-21,Gua-Policentro,8,DEP,,55,"01005002 9846","LOC.: 55.00",11345.68,Depositos,"21/08/2020 16:26:00",,
2020-08-21,"Gua-Principal ",8,N/C,6301779,52.52,517,"NO.RECAP:001444F1200821C PLA450479 MC.PAGO A ESTABL.450479000000000000     ",11398.2,Ocp-Pagos,"22/08/2020 0:57:32",,
2020-08-21,"Gua-Principal ",8,N/C,6302848,100.26,517,"NO.RECAP:001203F1200821C PLA451014 MC.PAGO A ESTABL.451014000000000000     ",11498.46,Ocp-Pagos,"22/08/2020 1:01:03",,
2020-08-24,"Gua-Principal ",8,CHE,,212.95,2340,"Pago De Cheques Normal Camara",11285.51,"Pago De Cheques Normal Camara","22/08/2020 4:01:46",,
2020-08-24,"Gua-Riocentro Ceibos",8,CHE,7857620,94.64,2294,"Pago De Cheques Normal Ventani",11190.87,"Pago De Cheques Normal Ventanilla","24/08/2020 11:33:12",,
2020-08-24,"Gua-Riocentro Ceibos",8,CHE,7857120,94.64,2354,"Pago De Cheques Normal Ventani",11096.23,"Pago De Cheques Normal Ventanilla","24/08/2020 11:33:47",,
2020-08-24,"Gua-Autobanco Albanbor",8,CHE,2640120,400,2361,"Pago De Cheques Normal Ventani",10696.23,"Pago De Cheques Normal Ventanilla","24/08/2020 12:33:26",,
2020-08-24,"Gua-Autobanco Albanbor",8,CHE,2638020,147.22,2346,"Pago De Cheques Normal Ventani",10549.01,"Pago De Cheques Normal Ventanilla","24/08/2020 12:36:01",,
2020-08-24,"Gua-Autobanco Albanbor",8,CHE,2637320,84.13,2358,"Pago De Cheques Normal Ventani",10464.88,"Pago De Cheques Normal Ventanilla","24/08/2020 12:36:46",,
2020-08-24,"Gua-Principal ",8,N/C,6581342,45,1945,"Concpto:01SOLICITUD DEL ORDENANTE VILLALA PEREZ GINGER KATIUSK                            000856P4",10509.88,"Transferencia Recibida Spi2 Del Bce","24/08/2020 13:23:15",,
2020-08-24,"Gua-Principal ",8,N/D,6581342,0.2,2884,"Concpto:01SOLICITUD DEL ORDENANTE VILLALA PEREZ GINGER KATIUSK                            000856P4",10509.68,"Transferencia Recibida Spi2 Del Bce","24/08/2020 13:23:15",,
2020-08-24,"Gua-Principal ",8,N/D,6581342,0.02,1613,"Concpto:01SOLICITUD DEL ORDENANTE VILLALA PEREZ GINGER KATIUSK                            000856P4",10509.66,"Transferencia Recibida Spi2 Del Bce","24/08/2020 13:23:15",,
2020-08-24,"Gua-Principal ",8,N/C,6928684,121.28,517,"NO.RECAP:001447F1200824C PLA456317 MC.PAGO A ESTABL.456317000000000000     ",10630.94,Ocp-Pagos,"25/08/2020 0:38:45",,
2020-08-25,"Gua-Principal ",8,CHE,,147.22,2345,"Pago De Cheques Normal Camara",10483.72,"Pago De Cheques Normal Camara","25/08/2020 3:49:32",,
2020-08-25,"Gua-Principal ",8,CHE,,176.11,2335,"Pago De Cheques Normal Camara",10307.61,"Pago De Cheques Normal Camara","25/08/2020 3:49:36",,
2020-08-25,"Gua-Principal ",8,CHE,,1292.96,2324,"Pago De Cheques Normal Camara",9014.65,"Pago De Cheques Normal Camara","25/08/2020 3:50:04",,
2020-08-25,"Gua-Principal ",8,N/C,6979390,148.17,1945,"Concpto:01TICKETSHOW S A-PAGO A TERCEROS TICKETSHOW S A                                   000856P4",9162.82,"Transferencia Recibida Spi2 Del Bce","25/08/2020 9:17:07",,
2020-08-25,"Gua-Principal ",8,N/D,6979390,0.2,2884,"Concpto:01TICKETSHOW S A-PAGO A TERCEROS TICKETSHOW S A                                   000856P4",9162.62,"Transferencia Recibida Spi2 Del Bce","25/08/2020 9:17:07",,
2020-08-25,"Gua-Principal ",8,N/D,6979390,0.02,1613,"Concpto:01TICKETSHOW S A-PAGO A TERCEROS TICKETSHOW S A                                   000856P4",9162.6,"Transferencia Recibida Spi2 Del Bce","25/08/2020 9:17:07",,
2020-08-25,"Pla-Principal Paseo Sh",8,CHE,4784320,189.85,2341,"Pago De Cheques Normal Ventani",8972.75,"Pago De Cheques Normal Ventanilla","25/08/2020 10:55:17",,
2020-08-25,"Gua-Autobanco Albanbor",8,CHE,2074120,1000,2366,"Pago De Cheques Normal Ventani",7972.75,"Pago De Cheques Normal Ventanilla","25/08/2020 15:24:45",,
2020-08-25,Gua-Urdesa,8,CHE,6550520,378.39,2370,"Pago De Cheques Normal Ventani",7594.36,"Pago De Cheques Normal Ventanilla","25/08/2020 15:56:51",,
2020-08-25,Gua-Urdesa,8,DEP,6548620,60,1972790,"EFE.: 60.00",7654.36,Depositos,"25/08/2020 15:59:44",,
2020-08-25,Gua-Urdesa,8,CHE,6548020,479.11,2373,"Pago De Cheques Normal Ventani",7175.25,"Pago De Cheques Normal Ventanilla","25/08/2020 16:01:10",,
2020-08-25,"Gua-Riocentro Ceibos",8,CHE,7596620,427.5,2367,"Pago De Cheques Normal Ventani",6747.75,"Pago De Cheques Normal Ventanilla","25/08/2020 16:22:35",,
2020-08-25,"Gua-Principal ",8,N/C,7418136,87.98,517,"NO.RECAP:001448F1200825C PLA468078 MC.PAGO A ESTABL.468078000000000000     ",6835.73,Ocp-Pagos,"26/08/2020 1:45:39",,
2020-08-25,"Gua-Principal ",8,CHE,,160.17,2365,"Pago De Cheques  Transferido N",6675.56,"Pago De Cheques  Transferido Normal","26/08/2020 2:46:11",,
2020-08-26,Gua-Urdesa,8,DEP,,200,"01003005 1204","EFE.: 200.00",6875.56,Depositos,"26/08/2020 14:22:08",,
2020-08-26,"Gua-Principal ",8,N/C,7937419,30.08,517,"NO.RECAP:001449F1200826C PLA471608 MC.PAGO A ESTABL.471608000000000000     ",6905.64,Ocp-Pagos,"27/08/2020 0:26:58",,
2020-08-27,"Gua-Principal ",8,CHE,,187.96,2336,"Pago De Cheques Normal Camara",6717.68,"Pago De Cheques Normal Camara","27/08/2020 3:30:01",,
